WWWWWWWWWWWW
W..........W
W..........W
W..........W
W..........W
W..........W
W..........W
WWWWWW.WWWWW