WWW.WWWWWWWW
W..........W
WWWWWWWWWW.W
W........W.W
W........W.W
W........W.W
W........W.W
WWWWWWWWWW.W