WWWWWWWWWWWW
W..........W
WWW.WWWWWW.W
W...W......W
W.WWWWWWWWWW
W.WW...WWWWW
W....W.....W
WWWWWWWWWW.W