WWWWWWWWWWWW
W......W...W
WWW.W......W
WWW...WWWW.W
WWW.W......W
WWW..WWW.WWW
WWWWWWW....W
WWWWWWWW.WWW